#tileset
tileset1.bmp
8 1
#level
54 62
0 0 0 0 0 0 0 0 0 0 0 7 0 0 7 0 0 0 0 0 7 0 0 0 0 0 0 2 0 0 7 3 0 0 0 0 0 0 0 0 0 0 0 0 0 0 0 0 0 3 3 3 3 3 
0 0 6 0 6 0 6 0 6 0 0 7 0 0 7 0 0 0 0 0 7 0 0 0 2 2 2 2 0 0 7 3 0 0 0 0 0 0 0 0 0 0 0 0 0 0 0 0 0 3 3 3 3 3 
0 0 7 7 7 7 7 7 7 0 0 7 0 0 0 0 0 0 0 0 7 0 0 0 2 0 0 2 0 0 7 3 0 0 0 0 0 0 0 0 0 0 0 0 0 0 0 0 0 3 3 3 3 3 
0 0 7 7 7 7 7 7 7 0 0 7 0 0 7 0 0 0 0 0 7 0 0 0 2 0 2 0 0 0 7 3 0 0 0 0 0 0 0 0 0 0 0 0 0 0 0 0 0 3 3 3 3 3 
0 0 7 7 7 7 7 7 7 0 0 7 0 0 7 0 0 0 0 0 7 0 0 2 0 0 0 2 0 0 7 3 0 0 0 0 0 0 0 0 0 0 0 0 0 0 0 0 0 3 3 3 3 3 
0 0 7 7 7 7 7 7 7 0 0 7 0 7 7 0 0 0 0 0 7 0 0 2 0 2 2 2 2 0 7 3 0 0 0 0 0 0 0 0 0 0 0 0 0 0 0 0 0 0 0 0 0 0 
0 0 7 7 7 7 7 7 7 0 0 7 0 0 7 0 0 0 0 0 7 0 0 2 0 2 0 0 0 0 0 0 0 0 0 0 0 0 0 0 0 0 0 0 0 0 0 0 0 0 0 0 0 0 
0 0 7 7 7 7 7 7 7 0 0 7 7 0 7 0 0 0 0 0 7 0 0 2 0 0 2 0 2 0 7 3 0 0 0 0 0 0 0 0 0 0 0 0 0 0 0 0 0 0 0 0 0 0 
0 0 7 7 7 7 7 7 7 0 0 7 0 0 7 0 0 0 0 0 7 0 0 0 2 2 0 0 2 2 7 3 0 0 0 0 0 0 0 0 0 0 0 0 0 0 0 0 0 0 0 0 0 0 
0 0 7 7 7 5 7 7 7 0 0 7 0 7 7 0 0 0 0 0 7 0 0 0 0 2 0 0 0 0 7 3 0 0 0 0 0 0 0 0 0 0 0 0 0 0 0 0 0 0 0 0 0 0 
0 0 0 0 0 0 0 0 0 6 0 7 0 0 7 0 0 0 0 0 7 0 0 0 0 0 2 2 0 0 7 3 0 0 0 0 0 0 0 0 0 0 0 0 0 0 0 0 0 0 0 0 0 0 
0 6 0 6 0 6 0 6 0 6 0 0 0 0 7 0 0 6 0 6 7 6 0 6 0 6 0 6 0 6 7 3 3 0 0 0 0 0 0 0 0 0 0 0 0 0 0 0 0 0 0 0 0 0 
7 7 7 7 7 7 7 7 7 7 7 7 7 7 7 0 7 7 7 7 7 7 7 7 7 7 7 7 0 7 7 3 3 0 0 0 0 0 0 0 0 0 0 0 0 0 0 0 0 0 0 0 0 0 
0 0 0 0 0 0 0 0 0 0 0 0 0 7 0 0 7 0 0 0 0 0 0 0 0 0 0 0 0 0 7 3 3 0 0 0 0 0 0 0 0 0 0 0 0 0 0 0 0 0 0 0 0 0 
0 0 0 0 0 0 0 0 0 0 0 0 0 0 0 0 7 0 0 0 0 0 0 0 0 0 0 0 0 0 7 3 3 0 0 0 0 0 0 0 0 0 0 0 0 0 0 0 0 0 0 0 0 0 
0 0 0 0 0 0 0 0 0 0 0 0 0 7 0 0 7 0 0 0 0 0 0 0 0 0 0 0 0 0 7 3 3 0 0 0 0 0 0 0 0 0 0 0 0 0 0 0 0 0 0 0 0 0 
0 0 0 0 0 0 0 0 0 0 0 0 0 7 0 0 7 0 0 0 0 0 0 0 0 0 0 0 0 0 7 3 3 0 0 0 0 0 0 0 0 0 0 0 0 0 0 0 0 0 0 0 0 0 
0 0 0 0 0 0 0 0 0 0 0 0 0 7 5 5 7 0 0 0 0 0 0 0 0 0 0 0 0 0 7 3 3 0 0 0 0 0 0 0 0 0 0 0 0 0 0 0 0 0 0 0 0 0 
0 0 0 0 0 0 0 0 0 0 0 0 0 7 3 3 7 0 0 0 0 0 0 0 1 1 1 1 1 0 7 3 3 0 0 0 0 0 0 0 0 0 0 0 0 0 0 0 0 0 0 0 0 0 
0 0 0 0 0 0 0 0 0 0 0 0 0 0 0 0 0 0 0 0 0 0 0 0 1 1 1 1 1 0 7 3 3 0 0 0 0 0 0 0 0 0 0 0 0 0 0 0 0 0 0 0 0 0 
0 0 0 0 0 0 0 0 0 0 0 0 0 0 0 0 0 0 0 0 0 0 0 0 1 1 1 1 1 0 7 3 3 0 0 0 0 0 0 0 0 0 0 0 0 0 0 0 0 0 0 0 0 0 
0 0 0 0 0 0 0 0 0 0 0 0 0 0 0 0 0 0 0 0 0 0 0 0 1 1 1 1 1 0 7 3 3 0 0 0 0 0 0 0 0 0 0 0 0 0 0 0 0 0 0 0 0 0 
0 0 0 0 0 0 0 0 0 0 0 0 0 0 0 0 0 0 0 0 0 0 0 0 1 1 1 1 1 0 7 3 3 0 0 0 0 0 0 3 3 0 0 0 0 0 0 0 0 0 0 0 0 0 
0 0 0 0 0 0 0 0 0 0 0 0 0 0 0 0 0 0 0 0 0 0 0 0 0 0 0 0 0 0 7 3 3 0 0 0 0 0 0 3 3 0 0 0 0 0 0 0 0 0 0 0 0 0 
6 0 6 0 6 0 6 0 6 0 6 0 6 0 6 0 6 0 6 0 6 0 6 0 6 0 6 0 6 0 7 3 3 0 0 0 0 0 3 3 0 0 0 0 0 0 0 0 0 0 0 0 0 0 
7 7 7 7 7 5 7 7 7 7 7 7 7 7 7 7 7 7 7 7 7 7 7 7 7 7 7 7 7 7 7 3 3 3 3 3 3 0 3 3 1 0 0 0 0 0 0 0 0 0 0 0 0 0 
3 3 3 3 7 4 7 3 3 3 3 3 3 3 3 3 3 3 3 3 3 3 3 3 3 3 3 3 3 3 3 3 3 0 3 3 3 3 3 3 3 0 0 0 0 0 0 0 0 0 0 0 0 0 
3 3 3 3 3 3 3 3 3 3 3 3 3 3 3 3 3 3 3 3 3 3 3 3 3 3 3 3 3 3 3 3 3 3 3 3 3 3 3 3 0 0 0 0 0 0 0 0 0 0 0 0 1 1 
0 1 0 0 1 0 1 0 0 0 0 0 0 0 0 0 0 0 0 0 1 0 1 1 1 0 0 0 0 0 0 0 0 0 0 0 7 3 3 3 1 1 0 3 3 3 3 0 0 0 1 1 1 1 
0 1 1 1 1 0 1 0 1 1 0 1 0 0 1 1 1 0 1 0 1 0 0 0 0 0 0 0 0 0 7 3 3 1 0 0 1 3 3 3 3 3 0 0 0 0 0 0 0 3 3 3 3 3 
0 0 1 1 1 0 1 0 1 0 1 1 1 1 0 0 0 0 1 0 0 0 1 0 0 1 0 0 0 0 7 1 1 0 0 0 0 1 0 3 3 3 3 1 1 0 1 0 0 3 3 3 3 3 
0 0 1 1 0 0 0 0 0 0 0 0 0 0 1 1 1 1 1 1 1 1 1 1 0 0 1 0 0 0 0 0 0 0 1 1 0 0 0 3 3 3 3 3 3 1 1 0 0 0 0 0 3 3 
0 0 0 1 0 0 0 1 0 0 1 1 1 0 0 0 0 0 0 0 0 0 0 1 0 0 0 1 1 1 1 1 0 1 0 1 0 0 0 3 3 3 3 3 3 1 0 0 0 3 3 0 3 3 
0 0 1 0 0 0 1 0 0 1 1 1 1 0 0 0 0 0 0 0 0 0 0 1 0 0 0 0 0 0 7 0 1 0 0 1 1 0 0 3 3 3 3 3 3 3 3 0 3 3 3 0 3 3 
0 0 0 0 0 1 1 0 1 0 0 0 0 0 0 1 1 1 1 1 1 1 0 1 1 1 1 1 1 0 0 0 0 0 0 1 1 0 0 0 0 0 0 3 3 3 3 3 3 3 0 0 0 0 
1 1 1 0 1 0 0 0 1 1 1 0 1 1 1 0 0 0 0 0 0 1 0 1 0 0 0 0 1 0 7 0 0 0 0 1 1 1 3 3 3 3 0 1 3 3 3 3 0 0 1 1 0 1 
0 0 0 0 1 0 0 1 1 1 1 0 1 1 1 0 1 1 0 0 1 0 0 1 1 0 1 1 1 0 7 0 0 0 0 0 0 0 3 3 1 1 0 1 3 3 1 0 0 0 0 0 0 1 
0 0 0 0 0 0 1 0 0 0 0 0 0 0 0 0 1 1 0 0 0 0 1 1 0 0 1 0 0 0 7 0 0 0 0 0 1 0 3 3 1 1 0 1 0 0 0 1 1 1 0 0 0 1 
0 1 0 0 0 1 0 0 0 1 1 1 1 1 1 1 0 1 1 1 0 1 1 0 0 0 1 1 0 0 0 7 0 0 0 1 0 0 0 3 3 0 0 1 0 0 0 0 0 0 0 1 1 1 
0 1 1 0 1 0 0 0 0 0 0 0 1 0 0 0 1 1 0 0 1 1 0 0 1 0 0 0 0 0 0 0 0 0 1 1 0 0 3 3 0 0 0 1 1 0 1 0 1 0 0 0 0 0 
0 0 0 0 0 0 0 1 1 1 1 0 0 1 0 1 1 1 0 1 1 0 0 0 1 0 0 0 0 0 0 0 1 0 1 0 0 0 3 3 0 0 0 1 0 0 1 0 1 0 1 1 0 0 
0 0 0 0 0 0 0 0 0 0 1 0 0 0 0 1 0 0 0 1 1 0 0 1 1 0 0 0 0 0 0 0 1 0 1 0 0 0 3 3 0 0 0 1 0 0 0 1 0 0 0 0 1 1 
0 1 0 1 1 1 1 1 1 1 1 1 1 1 1 0 0 1 0 1 0 1 0 0 0 0 0 0 1 1 1 1 0 0 0 0 1 1 3 3 0 0 1 1 2 2 2 0 0 0 0 0 1 1 
0 1 0 1 1 1 1 0 0 1 1 1 1 1 0 0 0 1 0 1 0 1 0 0 0 0 0 0 1 0 0 0 1 0 1 1 0 0 3 3 0 1 0 0 0 0 0 2 2 2 0 0 0 0 
0 0 0 1 0 0 0 0 0 0 0 0 1 0 0 1 1 0 0 1 0 1 0 0 1 0 0 0 1 0 1 0 1 0 1 0 0 0 3 3 0 1 0 0 2 2 0 2 0 0 2 0 0 0 
0 0 0 1 0 3 3 0 0 0 0 0 1 0 1 0 0 0 1 0 0 1 0 0 1 1 1 0 1 0 1 0 1 0 0 0 0 3 3 3 0 1 1 0 2 0 0 0 0 0 0 0 0 0 
0 1 0 0 0 3 0 0 1 1 0 0 1 1 0 0 1 1 3 3 0 1 0 0 1 1 0 0 1 0 1 0 1 1 1 0 3 3 3 1 0 0 1 0 2 2 0 1 1 1 0 2 2 0 
0 1 1 1 0 0 1 0 1 1 0 0 0 0 0 1 0 1 3 1 0 1 0 0 1 1 0 0 1 0 1 0 0 0 1 0 3 3 0 0 0 1 0 0 0 2 0 1 1 1 0 0 0 0 
0 0 1 0 0 0 0 0 1 1 0 0 0 0 1 1 0 1 3 3 0 0 0 0 1 0 0 0 1 0 1 1 0 0 0 1 3 3 1 1 0 0 0 0 0 0 0 0 0 0 2 0 2 2 
1 0 1 0 1 0 0 0 1 1 0 1 1 0 1 1 0 0 1 3 1 1 1 0 0 0 1 1 1 0 1 0 1 1 0 0 3 3 1 1 0 1 1 2 0 2 0 2 0 0 0 0 0 0 
0 0 0 0 1 0 3 3 3 3 0 0 1 0 0 1 1 0 1 1 0 0 0 0 1 0 0 0 0 0 1 0 0 0 1 1 3 3 1 0 0 0 0 0 0 0 2 0 2 2 0 2 2 1 
0 1 1 1 1 0 3 3 3 3 3 1 1 1 0 1 1 0 0 0 1 0 0 1 1 1 1 1 1 1 1 1 1 0 0 1 3 3 0 0 0 0 0 2 2 0 2 0 0 0 0 0 0 0 
0 1 1 1 1 1 0 0 0 1 0 0 0 1 0 1 1 1 0 0 1 0 0 0 0 0 0 0 0 0 1 0 0 0 0 3 3 0 0 0 0 0 0 0 2 0 2 1 1 0 0 0 1 0 
0 0 0 0 0 0 0 1 0 0 0 1 0 0 0 1 1 0 0 0 1 1 0 0 0 1 0 0 1 1 1 1 1 0 3 3 3 0 0 0 0 0 2 0 0 2 0 0 2 2 0 0 3 1 
1 1 0 1 1 0 0 0 0 0 0 0 0 1 1 1 0 1 1 0 0 1 0 0 1 1 0 1 0 0 1 0 1 0 3 3 0 0 0 0 0 2 0 0 0 0 2 0 0 2 0 3 3 3 
0 0 0 1 0 0 0 0 0 0 1 1 0 1 1 0 0 0 0 0 1 1 1 0 1 1 0 0 1 0 1 0 1 0 3 3 0 0 0 2 0 0 0 2 0 0 0 2 0 0 0 3 3 3 
0 1 1 0 0 0 3 3 3 1 1 3 0 0 0 0 1 0 0 1 0 0 0 0 0 0 0 0 0 0 1 0 1 0 3 3 1 2 2 0 2 0 0 0 0 0 0 0 0 0 3 3 3 3 
0 0 1 1 1 3 3 3 3 1 3 3 1 0 1 1 0 0 0 1 0 1 0 1 1 0 1 1 1 1 1 0 0 0 0 0 0 0 2 2 0 3 3 3 0 3 0 0 0 0 3 3 3 3 
1 0 1 0 0 1 1 1 1 0 1 1 0 1 0 1 1 1 0 1 0 1 0 0 0 1 0 0 0 0 1 0 1 0 0 3 3 0 2 0 0 0 0 0 0 3 3 3 0 3 3 3 3 3 
1 0 0 0 0 0 0 0 0 0 0 0 0 1 0 0 0 0 0 0 0 1 0 1 0 0 0 1 1 0 0 0 1 0 0 3 3 0 0 0 0 0 0 0 0 3 3 3 3 3 3 3 3 3 
